XXXXXXXXXX
XOOOOOOOOX
XGOOMOOOXX
XXOMOOOGXX
XXXOOXGXXX
XXXXOMOOOX
XXXXXOOXXX
XXXXXXXXXX